1 1
9 4
###########
#   #######
###   #####
#####   ###
#######   #
###########